校对的校对：
T 改得与字表一致
F 改得与字表不一致

F 嘻皮笑脸→嬉皮笑脸
T 下三滥→下三烂
T 雪里红→雪里蕻
T 做声→作声
F 做诗→作诗
T 坐位→座位
T 坐椅→座椅
T 做证→作证
T 哀嚎→哀号
F 返照→反照
F 功夫茶→工夫茶
T 嚎啕→号啕
F 呵叱→呵斥
F 话外音→画外音
T 义正辞严→义正词严
T 交待→交代
F 癞痢→瘌痢
牛圈quan→juan
T 攀龙附风→凤
T 乓贵神速→兵
F 陪笑脸→赔
T 起航→启
T 起行→启
T 入帐→入账
F 煞车→刹车
F 奢糜→奢靡
F 审察→审查
F 拾遗补缺→拾遗补阙
T 逃之天天→逃之夭夭
铁杉sha→shan
T 托辞→托词
T 惟恐→唯恐
F 帏幕→帷幕
T 惟一→唯一
T 惟有→唯有
无着zhe→zhuo
F 嘻闹→嬉闹
T 昔天同庆→普天同庆
F 嘻笑→嬉笑
F 像片→相片
销差cha→chai
F 销纳→消纳
F 小题大作→小题大做
F 省悟→醒悟
F 眩目→炫目
要著zhe→zhu
叶ye韵→xie
F 遗害→贻害
F 以致于→以至于
F 悠哉游哉→优哉游哉
T 瑜珈→瑜伽
T 渔汛→鱼汛
着zhe边→zhao
F 致词→致辞
F 执著→执着
F 爱答不理→爱搭不理
F 唉呀→哎呀
F 擘划→擘画
F 播弄→拨弄
T 不能自己→不能自已
F 布署→部署
F 仓猝→仓促
T 藏cang袍→zang
差cha派→chai
F 察颜观色→察言观色
T 超凡人ren圣→入ru
T 成想→承想
T 呈样、龙凤呈样→祥
F 词藻→辞藻
F 打颤→打战
T 单刀宜入→单刀直入
T 当做→当作
F 捣腾→倒腾
F 滴答→嘀嗒
T 掉包→调包
F 调转→掉转
堕地de→di
F 娥眉→蛾眉
T 发憷→发怵
F 繁冗→烦冗
T 风仙花→凤仙花
T 钢粱→钢梁
F 高梁、高梁面→粱
F 各行其事→各行其是
狗刨bao→pao
T 涵义→含义
T 寒颤→寒战
T 嚎哭→号哭
F 喉节→喉结
霍地di→de
F 稽察→稽查
T 嫉恶如仇→疾恶如仇
F 畸型→畸形
F 揭密→揭秘
迸jin飞→beng
T 进jin射→迸beng
T 竟购→竞购
T 开拨→开拔
T 看做→看作
F 克尽职守→恪尽职守
T 嘹望→瞭望
T 龙飞风舞→龙飞凤舞
T 啰嗦→啰唆
F 绿阴→绿荫
F 糜费→靡费
F 棉绸→绵绸
F 藐小→渺小
T 渺远→邈远
T 磨练→磨炼

好像没有的词语：
T 青下 青工
T 秋莱 秋菜
F 溶合
F 醺然
T 巡屉 巡展
T 膊裂 腭裂
T 睹咒 赌咒
T 昏天熙地 昏天黑地
T 莱案 菜案
T 露洒 露酒
